#########################
#0     ** *  1 * 2 *  * #
# # # #*# # #*#*# # # #*#
#  x*     ***  *  1   * #
# # # # # #*# # #*#*# # #
#f    2   1 x **  *  *  #
# # # # # # # # # #*# #*#
#*  *      *  *      *  #
# # # # #*# # # #*#*# # #
#*    **  *       *     #
# #*# # # # # # #*# # # #
#   2   1   *   *  *    #
# #*# # # # # # # # #*# #
#########################